*********
*       *
*   *   *
* S * E *
*   *   *
*       *
*********  