*********
*       *
*   *   *
* S *   *
*   * E *
*   *   *
*       *
*********